#########################
#...x..1.x.1...x..1.....#
#x#r#x#.#x#.#.#.#.#x#.#.#
#.....p....x............#
#n#n#s#.#.#.#.#.#.#.#.#.#
#........2..............#
#.#.#.#.#.#.#.#.#.#.#.#.#
#.......................#
#.#.#.#.#.#.#.#.#.#.#.#.#
#..............2........#
#.#.#.#.#.#.#.#.#.#.#.#.#
#.......................#
#.#.#.#.#.#.#.#.#.#.#.#.#
#....................2..#
#########################