#########################
#..n.1x1.x..x..x...1....#
#.#.#x#.#.#.#.#.#.#.#.#.#
#trxxx.x.x.xxnx.x..xx...#
#x#.#.#.#.#.#.#.#.#.#.#.#
#rxx.n..xx..x..xx..1....#
#x#.#x#.#.#.#.#.#.#.#.#.#
#..x.x1x.1..x..xxx...x.1#
#.#x#.#.#.#.#.#.#.#.#.#.#
#x.1.r.x.x.rx.xp.1.x.x..#
#.#.#x#.#.#x#.#.#.#x#.#.#
#x.x..rx.x.n.1xxx.x1.xr.#
#.#x#.#x#.#.#.#.#.#.#.#x#
#.xx..1.xnx.1.x.n..x...1#
#########################