#########################
#..n.3x1.x..s..x...1....#
#.#.#x#.#.#.#.#.#.#.#.#.#
#rxspx.....x...x...x....#
#.#.#.#.#.#.#.#.#.#.#.#.#
#xxx.n..xx..x..xx..1....#
#x#.#x#.#.#.#.#.#.#.#.#.#
#..x...x.1..x..x.x...x.1#
#.#x#.#.#.#.#.#.#.#.#.#.#
#x.1.r.x...rx.x..1.x.x..#
#.#.#x#.#.#x#.#.#.#x#.#.#
#x.x..xx.x.n..xxx.x..xr.#
#.#x#.#x#.#.#.#.#.#.#.#x#
#..x..1.xnx.1.x.n..x...1#
#########################