#########################
#........xxxxxxxxx......#
#.#t#.#.#x#.#.#.#.#.#.#.#
#t...t.x........xxx.....#
#.#.#.#.#.#.#.#.#.#.#.#.#
#...n..r....n....5......#
#.#.#.#x#.#.#.#.#.#.#.#.#
#.....x..5..............#
#.#.#.#.#.#.#.#.#.#.#.#.#
#..s...5.....xxx........#
#.#.#.#.#.#.#.#.#.#.#.#.#
#.xxx....xxxxx..........#
#.#.#.#.#.#.#.#.#.#.#.#.#
#..x.x.....4....xxx..x..#
#########################