#########################
#....n.......xx...x.....#
#.#.#.#.#.#.#.#.#.#.#.#.#
#x.rs....i.p...2........#
#.#.#.#.#.#.#.#x#.#.#.#.#
#.......xxxxx......x....#
#.#.#.#x#.#.#.#x#.#.#.#.#
#.....x...2......x......#
#.#.#x#.#.#.#.#.#.#.#.#.#
#...x....x.....1........#
#x#x#.#.#x#.#.#.#.#.#.#.#
#..........x......3.....#
#.#.#.#.#.#.#.#.#.#.#.#.#
#..3.....xxx.....3......#
#########################