#########################
#..n..x..x.....x........#
#.#.#x#.#.#.#.#.#.#.#.#.#
#rxs.x.....x...x........#
#.#.#.#.#.#.#.#.#.#.#.#.#
#..x.....x..p..x........#
#.#.#.#.#.#.#.#.#.#.#.#.#
#..x...x....x....x...x.1#
#.#.#.#.#.#.#.#.#.#.#.#.#
#......x......x......x..#
#.#.#.#.#.#.#.#.#.#.#.#.#
#..x.....x....x...x..x..#
#.#.#.#.#.#.#.#.#.#.#.#.#
#..x....x.....x....x....#
#########################