#########################
#....x.1....x....1......#
#.#.#.#.#x#.#.#.#.#.#.#.#
#..x...p..x......x......#
#x#.#.#x#.#.#.#.#.#.#x#x#
#..........x......x.....#
#.#.#.#.#.#.#.#.#.#.#.#.#
#....x.........x........#
#.#.#.#.#.#.#.#.#.#.#.#.#
#...x..1...x.....x...x..#
#.#.#.#.#.#.#x#.#.#.#.#.#
#..1x...x....1.x........#
#.#x#.#.#.#.#.#.#.#.#.#.#
#..........x.......1....#
#########################